NO ./wallTexture/Black/prototype.png
SO ./wallTexture/Black/prototype.png
WE ./wallTexture/Black/prototype.png
EA ./wallTexture/Black/prototype.png
C	225		,30, 5
F 88, 24, 69 

1111121111111
1000000000001
1000000000001
1000000000001
1000000000001
1000000000001
1000000000001
1000000000001
1000000000001
1000000000001
100000W000001
1000000000001
1000000000001
1000000000001
1000000000001
1000000000001
1000000000001
1000000000001
1000000000001
1000000000001
1111111111111