NO ./wallTexture/north.png
SO ./wallTexture/south.png
WE ./wallTexture/west.png
EA ./wallTexture/east.png
C	225		,30, 5
F 220,100,	0

1111111111111
1000000000001
1000000000001
1000000000001
1000000000001
1000000000001
1000000000001
1000000000001
1000000000001
1000000000001
100000S000001
1000000000001
1000000000001
1000000000001
1000000000001
1000000000001
1000000000001
1000000000001
1000000000001
1000000000001
1111111111111
