NO ./wallTexture/francoma.png
SO ./wallTexture/seroy.png
WE ./wallTexture/west.png
EA ./wallTexture/east.png

C 100, 170, 255

F 70, 45,  45




11111111111111111111111111111
10000000011110100011111000001
10101111110011111110001111101
10011111000011111100000111101
10111110010011111001100111101
10111100110011111111001111101
10000000000000000000000000001
10000000000N00000000000000001
10111000000000111110011111101
10111111110011111001111111101
10111111110011110000001111101
10111111111111111111111111101
10000000000000000000000000001
10010010010001000111111111111
11111111111111111111111111111