NO ./wallTexture/francoma.png
SO ./wallTexture/seroy.png
WE ./wallTexture/west.png
EA ./wallTexture/east.png


F 220,-42,0
C 34, 56, 44

111111111111111111111111111
100000000000000000000000001
1000N0001110000001111100001
100000110110000010001100001
100001100110000000011000001
100011111111100001100000001
100000000110000011000000001
100000000110000111111000001
100000000000000000000000001
111111111111111111111111111