		NO ./wallTexture/Green_100/tex_G_100_01.png

SO ./wallTexture/Green_100/tex_G_100_02.png

		WE ./wallTexture/Green_100/tex_G_100_03.png

EA ./wallTexture/Green_100/tex_G_100_04.png

F  		220,100,0

C 			225,30,0






1111111111111
1000000000001
1000000000001
1000000000001
100000N000001
1111111111111

1111111111111
1000000000001
1000000000001
1000000000001
1111111111111











